1
0 0 0 0 0 0 0 0,0 0 0 0 0 0 0 0,0 0 0 0 0 0 0 0,0 0 0 0 0 0 0 0,0 0 0 0 0 0 0 0,0 0 0 0 0 0 0 0,0 0 0 0 0 0 0 0,0 0 0 0 0 0 0 0
0 0 0 0 0 0 0 0,0 0 6 0 1 1 2 0,0 9 0 3 8 5 0 0,0 2 0 1 1 0 3 0,0 9 4 7 9 6 0 0,0 9 1 9 5 1 0 0,0 7 2 7 8 8 4 0,0 0 0 0 0 0 0 0
0 0 0 0 0 0 0 0,0 0 8 8 3 4 8 0,0 3 4 3 9 0 0 0,0 3 4 3 7 0 2 0,0 9 6 3 0 5 9 0,0 2 6 8 1 5 4 0,0 0 1 0 0 4 0 0,0 0 0 0 0 0 0 0
0 0 0 0 0 0 0 0,0 1 4 0 0 2 1 0,0 0 5 2 8 3 0 0,0 7 7 2 0 2 2 0,0 6 8 0 0 1 5 0,0 2 1 0 7 8 0 0,0 6 7 0 0 4 7 0,0 0 0 0 0 0 0 0
0 0 0 0 0 0 0 0,0 9 9 7 1 7 9 0,0 5 7 9 6 0 3 0,0 0 3 1 9 9 2 0,0 0 0 0 3 6 6 0,0 0 0 0 5 0 3 0,0 7 4 9 8 0 7 0,0 0 0 0 0 0 0 0
0 0 0 0 0 0 0 0,0 4 1 1 6 1 0 0,0 5 4 7 5 6 4 0,0 3 5 2 0 6 3 0,0 7 5 8 5 0 8 0,0 0 4 0 0 2 2 0,0 9 6 6 6 5 0 0,0 0 0 0 0 0 0 0
0 0 0 0 0 0 0 0,0 0 4 7 0 0 4 0,0 0 5 5 5 0 8 0,0 9 0 3 8 8 3 0,0 8 6 6 2 1 9 0,0 2 0 0 8 7 3 0,0 5 4 4 6 0 2 0,0 0 0 0 0 0 0 0
0 0 0 0 0 0 0 0,0 0 0 0 0 0 0 0,0 0 0 0 0 0 0 0,0 0 0 0 0 0 0 0,0 0 0 0 0 0 0 0,0 0 0 0 0 0 0 0,0 0 0 0 0 0 0 0,0 0 0 0 0 0 0 0