0 0 0 0 0 0 0
0 3 6 7 6 6 0
0 3 1 1 1 4 0
0 1 2 2 8 9 0
0 4 2 3 2 1 0
0 7 9 1 2 2 0
0 0 0 0 0 0 0
