0 0 0 0 0 0 0
0 1 7 4 4 1 0
0 3 7 4 4 2 0
0 6 3 2 8 6 0
0 9 3 1 2 3 0
0 7 2 5 6 7 0
0 0 0 0 0 0 0