0 0 0 0 0 0 0
0 6 4 1 1 3 0
0 4 4 4 4 9 0
0 2 1 2 2 6 0
0 2 9 2 4 3 0
0 1 6 7 5 3 0
0 0 0 0 0 0 0