0 0 0 0 0 0 0
0 6 4 7 3 1 0
0 1 4 8 2 9 0
0 6 6 6 2 1 0
0 7 9 6 4 6 0
0 4 0 1 8 3 0
0 0 0 0 0 0 0