0 0 0 0 0 0 0
0 7 4 4 1 7 0
0 2 1 3 4 9 0
0 2 1 6 2 9 0
0 6 3 1 2 3 0
0 7 3 2 4 5 0
0 0 0 0 0 0 0